________________________________
|..............................|
|..............................|
|..............................|
|..............................|
|..............................|
|..............................|
|..............................|
|..............................|
|..............................|
|..............................|
D@*............................|
|..............................|
|..............................|
|..............................|
|..............................|
|..............................|
|..............................|
|..............................|
|..............................|
|..............................|
|..............................|
|..............................|
|..............................|
|..............................|
|..............................|
|..............................|
|..............................|
|..............................|
|..............................|
|..............................|
________________________________
