________________________________
|..............................|
|..............................|
|..............................|
|..............................|
|..............................|
|..............................|
|..............................|
|..............................|
|..............................|
|..............................|
@*.............................|
|..............................|
|..............................|
|..............................|
|..............................|
|..............................|
|..............................|
|..............................|
|..............................|
|..............................|
|..............................|
|..............................|
|..............................|
|..............................|
|..............................|
|..............................|
|..............................|
|..............................|
|..............................|
|..............................|
________________________________
