________________________________
|..............................|
|..............................|
|..............................|
|..............................|
|..............................|
|..............................|
|..............................|
|..............................|
|..............................|
|..............................|
D@.............................|
|..............................|
|..............................|
|..............................|
|..............................|
|..............................|
|..............................|
|..............................|
|..............................|
|..............................|
|..............................|
|..............................|
|..............................|
|..............................|
|..............................|
|..............................|
|..............................|
|..............................|
|..............................|
|..............................|
________________________________
