________________________________
|..............................|
|..............................|
|.......................&......|
|..............................|
|.........O....................|
|..............................|
|..............................|
|....*.......&.................|
|..............................|
|..............................|
|..............................|
|..............................|
|...................&..........|
|..............................|
|..............................|
|..............................|
|..............................|
|........*.....................|
|..............................|
|..............................|
|..............................|
|..............................|
|..............................|
|..............................|
|..............................|
|...............O..............|
|..............................|
|..............................|
|..............................|
|..............................|
________________________________
