________________________________
|..............................|
|..............................|
|..............................|
|..............................|
|.........O....................|
|..............................|
|..............................|
|....*.......&.................|
|..............................|
|..............................|
@..............................|
|..............................|
|..............................|
|..............................|
|..............................|
|..............................|
|..............................|
|..............................|
|..............................|
|..............................|
|..............................|
|..............................|
|..............................|
|..............................|
|..............................|
|..............................|
|..............................|
|..............................|
|..............................|
|..............................|
________________________________
